1111111111111
1E10000000001
1010111C111C1
100C11P000001
1111111111111