1111111111111
1P100000000N1
1010111C111C1
100C11E000001
1111111111111